[hashtable]
Numéro_Inconnu=Désolé, le numéro que vous avez demandé n'est plus attribué. Veuillez réessayer ultérieurement.
Bye=Va voir ailleurs si j'y suis, et si j'y suis pas bah... restes-y!
GTFO=GTFO!!!
Tonnerre=Pikachu, attaque 1,8TONNERRE! 7$$1 est littéralement électrocuté!
Raichu="En avant, Raichu!" 7TOYYINNNDJDJDJ !!!!! 6$$1 : Qu'est-ce c'est que ce cri... FUYONS!!!
Ramzy=J'annonce... coup de pied latéral, en pleine face!
Rascal=La fête est finie, rascal!
Eric=Attends tais-toi pour voir... Ah ouais c'est bien!
Luffy=GOMU GOMU NO... 8GIGANT PISTOL!!!!! $$1 est éjecté de la pièce avec force...
Surf=Carapuce, attaque Surf! Une rafale d'eau s'abat sur $$1 et l'emporte loin, très loin...
Sailor_Moon=Paillettes d'argent, agissez tout de suite!
Kick_Porte=Reviens plus tard. Bien plus tard.
Mic_Check=Test 1..2..1..2.. ah ben non ca marche pas!
Porte=|¯| <- Go prendre la porte
Artikodin="Artikodin! A l'attaque!" 2ARTIKODIN balance un 0,11LASER-GLACE dans la tronche de 7$$1, hop, 2 semaines d'angine!!
Tortank="Hé Tortank ! Regarde-moi 7$$1! Pour qui il se prend ???" A-Attaque 2HYDROCANON ??!!! 7$$1 s'est fait expulser de 3<chan> tellement la vague était forte !
Rondoudou="Rondoudou, attaque Berceuse !" 13RONDOUDOU se met soudainement à chanter : 4Rondoudou dou rondoudou dou rondoudou dou... 6$$1 s'est endormi... Mais... <nick> lui fait les poches?!
Dracaufeu="Fini la rigolade, j'appelle... 4DRACAUFEU!!! Hahaha... Hein?! AAAAAH!!!" 4DRACAUFEU balance un tourbillon de flammes qui brûle 7$$1 et 6<nick> par la même occasion... Dommage ^^
Hacktou="Hé, $$1, j'ai un code pour toi: Tape /run shutdown.exe et tu pourras devenir op!!!!" ..... $$1 a quitté IRC (Connection reset by peer)
Gline=$$1 a quitté IRC (User banned from <net>)
Méditation=Le repos est bon pour la santé, va donc te reposer un peu!
Pub=La publicité est interdite sur ce canal.
Badwords=Va te calmer.
Majs=N'utilisez pas trop de majuscules.
Flood=Le flood est interdit sur ce canal.
Cool=Désolé, on n'accepte que des gens cools ici.
Qui=Qui-êtes vous?
Bouton_Kick=Oh comme j'adore presser cette touche ^3^
Bouton_test=Random kick de test ^^
Sacrifice=Après longue délibération, il a été décidé que ce serait toi qui serait le bouc émissaire. Nous sommes heureux de t'avoir connu, puisse-tu reposer en paix!
Feinte="Oh regarde là bas, c'est Justin Bieber!!!" $$1 pousse $$1 hors du canal pendant qu'il tourne la tête.
Tyran=LA LOI, C'EST MOI!
Reine=QU'ON LUI COUPE LA TÊTE!!!!
Enfer=On se reverra en enfer.
Maillon_Faible=Vous êtes le maillon faible, AU REVOIR!
Merci=Merci de ta visite ^^
Op=Les Ops ont toujours raison (sisi!)
Kaira=Wech vasy casse toi la natchav de là ma gueule!
Countdown=La bombe est sur le point d'exploser... 3... 2... 1... BOOM!